//MAP CONVERTED BY dmm2tgm.py THIS HEADER COMMENT PREVENTS RECONVERSION, DO NOT REMOVE
"a" = (
/turf/open/water/beach/deep,
/area/space)
"b" = (
/turf/open/floor/plating/asteroid/whitesands/grass/dead/lit,
/area/space)
"c" = (
/obj/item/stack/sheet/mineral/uranium/ten,
/obj/machinery/atmospherics/pipe/heat_exchanging/manifold{
	dir = 8
	},
/turf/open/floor/concrete/reinforced,
/area/space)
"d" = (
/obj/structure/flora/tree/tall,
/turf/open/floor/plating/grass/lava/purple,
/area/space)
"e" = (
/obj/structure/flora/tree/tall,
/turf/open/floor/plating/asteroid/whitesands/grass/dead/lit,
/area/space)
"f" = (
/obj/machinery/atmospherics/pipe/heat_exchanging/simple,
/turf/open/space/basic,
/area/space)
"g" = (
/turf/open/floor/plating/asteroid/whitesands/lit,
/area/space)
"h" = (
/turf/open/water/beach,
/area/space)
"i" = (
/obj/machinery/atmospherics/pipe/heat_exchanging/simple{
	dir = 6
	},
/turf/open/water/tar,
/area/space)
"j" = (
/obj/machinery/atmospherics/pipe/heat_exchanging/simple{
	dir = 10
	},
/turf/open/water/tar,
/area/space)
"k" = (
/obj/machinery/atmospherics/pipe/heat_exchanging/manifold4w,
/obj/effect/anomaly/heartbeat,
/turf/open/floor/concrete/reinforced,
/area/space)
"l" = (
/obj/structure/flora/ash/garden/waste,
/turf/open/floor/plating/asteroid/whitesands/grass/dead/lit,
/area/space)
"m" = (
/turf/open/water/tar,
/area/space)
"n" = (
/turf/open/floor/plasteel/dark,
/area/space)
"o" = (
/obj/machinery/atmospherics/pipe/heat_exchanging/simple{
	dir = 6
	},
/obj/machinery/power/rad_collector/anchored,
/turf/open/floor/concrete/reinforced,
/area/space)
"p" = (
/turf/closed/wall/r_wall/syndicate/nodiagonal,
/area/space)
"q" = (
/obj/machinery/atmospherics/pipe/heat_exchanging/simple{
	dir = 5
	},
/turf/open/water/tar,
/area/space)
"r" = (
/obj/structure/flora/tree/dead_pine,
/turf/open/floor/plating/asteroid/whitesands/grass/lit,
/area/space)
"s" = (
/turf/open/floor/plating,
/area/space)
"t" = (
/obj/machinery/atmospherics/pipe/heat_exchanging/simple{
	dir = 5
	},
/obj/machinery/power/rad_collector/anchored,
/turf/open/floor/concrete/reinforced,
/area/space)
"u" = (
/obj/structure/flora/tree/palm,
/turf/open/floor/plating/asteroid/whitesands/lit,
/area/space)
"v" = (
/turf/open/floor/plating/dirt/jungle/wasteland/lit,
/area/space)
"w" = (
/turf/open/floor/plating/asteroid/sand/lit,
/area/space)
"x" = (
/obj/machinery/atmospherics/pipe/heat_exchanging/simple{
	dir = 9
	},
/obj/machinery/power/rad_collector/anchored,
/turf/open/floor/concrete/reinforced,
/area/space)
"y" = (
/obj/structure/flora/ash/glowshroom,
/turf/open/floor/plating/asteroid/whitesands/grass/lit,
/area/space)
"z" = (
/obj/structure/flora/tree/dead/tall,
/turf/open/floor/plating/asteroid/whitesands/grass/lit,
/area/space)
"A" = (
/obj/structure/flora/tree/dead/barren,
/turf/open/floor/plating/asteroid/whitesands/grass/lit,
/area/space)
"B" = (
/obj/machinery/atmospherics/pipe/heat_exchanging/manifold{
	dir = 4
	},
/obj/item/stack/sheet/mineral/uranium/ten,
/turf/open/floor/concrete/reinforced,
/area/space)
"C" = (
/obj/effect/radiation/waste/intense,
/turf/open/floor/plating/grass/lava/purple,
/area/space)
"D" = (
/turf/open/space/basic,
/area/space)
"E" = (
/turf/closed/wall/concrete,
/area/space)
"F" = (
/turf/open/floor/plating/asteroid/whitesands/grass/lit,
/area/space)
"G" = (
/obj/structure/fluff/fokoff_sign{
	icon_state = "fokrads"
	},
/turf/open/floor/plating/dirt/jungle/wasteland/lit,
/area/space)
"H" = (
/obj/machinery/atmospherics/pipe/heat_exchanging/manifold{
	dir = 1
	},
/turf/open/water/tar,
/area/space)
"I" = (
/obj/structure/fluff/fokoff_sign{
	icon_state = "fokrads"
	},
/turf/open/space/basic,
/area/space)
"J" = (
/obj/machinery/atmospherics/pipe/heat_exchanging/simple{
	dir = 4
	},
/turf/open/water/tar,
/area/space)
"K" = (
/obj/machinery/atmospherics/pipe/heat_exchanging/manifold4w,
/turf/open/water/tar,
/area/space)
"L" = (
/obj/structure/flora/tree/dead/barren,
/turf/open/floor/plating/asteroid/whitesands/grass/dead/lit,
/area/space)
"M" = (
/obj/structure/flora/tree/dead/tall/grey,
/turf/open/floor/plating/asteroid/whitesands/grass/lit,
/area/space)
"N" = (
/turf/open/floor/concrete/slab_4,
/area/space)
"O" = (
/obj/effect/radiation/waste/intense,
/turf/open/floor/plating/asteroid/whitesands/grass/dead/lit,
/area/space)
"P" = (
/turf/open/floor/plating/grass/lava/purple,
/area/space)
"Q" = (
/obj/structure/fluff/fokoff_sign{
	icon_state = "fokrads"
	},
/turf/open/floor/plating/asteroid/whitesands/lit,
/area/space)
"R" = (
/obj/structure/flora/ash/garden/waste,
/turf/open/floor/plating/asteroid/whitesands/grass/lit,
/area/space)
"S" = (
/obj/structure/fluff/fokoff_sign{
	icon_state = "fokrads"
	},
/turf/open/floor/plating/asteroid/sand/lit,
/area/space)
"T" = (
/obj/machinery/atmospherics/pipe/heat_exchanging/manifold,
/obj/item/stack/sheet/mineral/uranium/ten,
/turf/open/floor/concrete/reinforced,
/area/space)
"U" = (
/obj/item/stack/sheet/mineral/uranium/ten,
/obj/machinery/atmospherics/pipe/heat_exchanging/manifold4w,
/turf/open/floor/concrete/reinforced,
/area/space)
"V" = (
/obj/machinery/atmospherics/pipe/heat_exchanging/simple{
	dir = 10
	},
/obj/machinery/power/rad_collector/anchored,
/turf/open/floor/concrete/reinforced,
/area/space)
"W" = (
/obj/effect/radiation/waste/intense,
/turf/open/floor/plating/asteroid/whitesands/lit,
/area/space)
"X" = (
/obj/machinery/atmospherics/pipe/heat_exchanging/simple{
	dir = 9
	},
/turf/open/water/tar,
/area/space)
"Y" = (
/obj/effect/radiation/waste/intense,
/turf/open/floor/plating/asteroid/whitesands/grass/lit,
/area/space)
"Z" = (
/obj/structure/flora/tree/dead/tall,
/turf/open/floor/plating/asteroid/whitesands/grass/dead/lit,
/area/space)

(1,1,1) = {"
D
D
D
D
D
D
D
D
D
D
D
D
D
D
D
D
D
D
D
D
D
D
D
D
D
D
D
D
D
D
D
D
D
D
D
D
D
D
D
D
"}
(2,1,1) = {"
D
D
D
D
D
D
D
D
D
D
D
D
D
D
D
D
D
D
D
D
D
D
D
D
D
D
D
D
D
D
D
D
D
D
D
D
D
D
D
D
"}
(3,1,1) = {"
D
D
D
D
D
D
D
D
D
D
D
D
D
D
D
D
D
D
D
D
D
D
D
D
D
D
D
D
D
D
D
D
D
D
D
D
D
D
D
D
"}
(4,1,1) = {"
D
D
D
D
D
D
D
D
D
S
w
w
w
w
w
D
D
D
D
D
D
D
D
D
D
D
D
D
D
D
D
D
D
D
D
D
D
D
D
D
"}
(5,1,1) = {"
D
D
D
D
D
D
D
D
w
w
w
w
w
w
w
w
D
D
D
D
D
D
D
D
D
D
D
D
D
D
D
D
D
D
D
D
D
D
D
D
"}
(6,1,1) = {"
D
D
D
D
D
D
D
w
w
w
w
w
w
w
w
w
w
D
D
D
D
D
D
D
D
D
D
D
I
D
D
D
D
D
D
D
D
D
D
D
"}
(7,1,1) = {"
D
D
D
D
D
D
w
w
w
w
w
w
w
w
w
w
w
S
D
D
D
D
D
D
D
D
D
D
D
D
D
D
D
D
D
D
D
D
D
D
"}
(8,1,1) = {"
D
D
D
D
D
w
w
w
w
h
h
h
h
h
w
w
w
w
D
D
D
D
D
D
D
D
D
D
D
D
D
D
D
D
D
D
D
D
D
D
"}
(9,1,1) = {"
D
D
D
w
w
w
w
w
w
h
h
h
h
h
h
h
w
w
D
D
D
D
D
D
D
D
D
D
D
D
D
D
D
D
D
D
D
D
D
D
"}
(10,1,1) = {"
D
D
D
w
w
w
w
w
h
h
m
m
h
h
h
m
m
w
g
D
D
D
D
D
D
D
D
D
D
D
D
D
D
D
D
D
D
D
D
D
"}
(11,1,1) = {"
D
D
S
w
w
w
w
h
h
h
m
a
a
a
m
g
g
g
D
D
D
D
D
D
D
D
D
D
D
D
D
D
D
D
D
D
D
D
D
D
"}
(12,1,1) = {"
D
D
w
w
w
w
h
h
h
m
a
a
a
a
m
g
g
g
g
D
D
D
D
D
D
D
D
D
D
D
D
D
D
D
D
D
D
D
D
D
"}
(13,1,1) = {"
D
D
w
w
w
h
h
h
h
m
m
a
m
a
m
m
g
g
g
D
D
D
D
D
D
D
D
D
D
D
D
D
D
D
D
D
D
D
D
D
"}
(14,1,1) = {"
D
D
w
w
w
h
h
h
h
m
m
a
m
a
m
m
g
g
g
D
D
D
D
D
D
D
D
D
D
D
D
D
D
D
D
D
D
D
D
D
"}
(15,1,1) = {"
D
D
w
w
w
h
h
h
a
m
m
a
m
m
m
m
g
g
g
D
D
n
n
n
n
n
n
n
n
n
D
D
D
D
D
D
D
D
D
D
"}
(16,1,1) = {"
D
D
w
w
w
h
h
h
a
a
m
m
m
m
m
m
E
E
E
E
D
n
n
n
n
n
n
n
n
n
D
D
D
D
D
D
D
D
D
D
"}
(17,1,1) = {"
D
D
w
w
w
h
h
h
a
a
m
a
m
m
m
m
E
i
q
E
D
n
n
p
p
N
p
p
n
n
D
D
D
D
D
D
D
D
D
D
"}
(18,1,1) = {"
D
D
w
w
w
h
h
h
m
a
m
m
m
m
m
E
E
J
J
E
D
n
n
p
N
N
N
p
n
n
D
D
D
D
D
D
D
D
D
D
"}
(19,1,1) = {"
D
D
w
w
w
h
h
m
m
a
m
a
m
a
m
a
m
J
J
E
D
n
n
p
p
N
p
p
n
n
D
D
D
D
D
D
D
D
D
D
"}
(20,1,1) = {"
D
D
w
w
w
h
h
m
a
a
a
a
m
m
m
m
m
J
J
E
D
D
D
p
o
c
t
p
n
n
D
D
D
D
I
D
D
D
D
D
"}
(21,1,1) = {"
D
D
w
w
w
h
m
h
a
a
m
m
m
m
m
m
m
H
K
f
f
f
f
f
U
k
T
s
n
n
D
D
D
D
D
D
D
D
D
D
"}
(22,1,1) = {"
D
D
w
w
w
h
h
h
h
a
a
m
a
m
m
m
m
J
J
E
D
D
D
p
V
B
x
p
n
n
D
D
D
D
D
D
D
D
D
D
"}
(23,1,1) = {"
D
D
w
w
w
h
h
h
a
a
m
m
m
a
m
m
m
J
J
E
D
n
n
p
p
N
p
p
n
n
D
D
D
D
D
D
D
D
D
D
"}
(24,1,1) = {"
D
D
w
w
w
h
h
m
a
a
a
m
m
m
m
E
E
J
J
E
D
n
n
p
N
N
N
p
n
n
D
D
D
D
D
D
D
D
D
D
"}
(25,1,1) = {"
D
D
w
w
w
h
h
a
a
a
a
m
a
m
m
a
E
j
X
E
D
n
n
p
p
N
p
p
n
n
D
D
D
D
D
D
D
D
D
D
"}
(26,1,1) = {"
D
D
D
S
w
h
h
a
a
a
a
m
a
m
m
m
E
E
E
E
D
n
n
n
n
n
n
n
n
n
D
D
D
D
D
D
D
D
D
D
"}
(27,1,1) = {"
D
D
D
w
w
h
h
h
a
a
m
m
m
m
m
g
g
g
g
D
D
n
n
n
n
n
n
n
n
n
D
D
D
D
D
D
D
D
D
D
"}
(28,1,1) = {"
D
D
D
w
w
w
h
h
a
a
a
m
m
m
m
m
g
g
g
g
g
D
D
D
D
D
D
D
D
D
D
D
D
D
D
D
D
D
D
D
"}
(29,1,1) = {"
D
D
D
D
w
w
h
h
h
m
m
a
a
m
m
m
m
g
g
g
g
g
g
D
D
D
D
D
D
D
D
D
D
D
D
D
D
D
D
D
"}
(30,1,1) = {"
D
D
D
D
D
w
w
h
h
m
m
h
m
m
m
m
g
g
g
g
g
v
v
g
D
D
D
D
D
D
D
D
D
D
D
D
D
D
D
D
"}
(31,1,1) = {"
D
D
D
D
D
w
g
g
m
m
m
m
m
h
m
g
g
g
b
b
b
b
v
g
g
D
D
D
D
D
D
D
D
D
D
D
D
D
D
D
"}
(32,1,1) = {"
D
D
D
D
D
g
g
g
m
g
g
g
g
g
g
g
g
F
F
b
b
b
v
v
g
g
D
D
D
D
D
D
D
D
D
D
D
D
D
D
"}
(33,1,1) = {"
D
D
D
D
D
g
v
v
g
g
g
g
g
g
u
b
b
F
F
b
b
b
b
v
g
g
D
D
D
D
D
D
D
D
D
D
D
D
D
D
"}
(34,1,1) = {"
D
D
D
D
D
g
G
v
v
g
g
g
g
W
b
b
b
O
b
O
b
b
b
v
v
g
D
D
D
D
D
D
D
D
D
D
D
D
D
D
"}
(35,1,1) = {"
D
D
D
D
D
g
v
v
b
b
b
b
b
b
b
b
b
F
y
b
b
b
b
b
v
g
g
D
D
D
D
D
D
D
D
D
D
D
D
D
"}
(36,1,1) = {"
D
D
D
D
g
g
v
v
b
b
b
b
b
b
b
b
b
F
F
b
b
b
b
b
v
v
g
D
D
D
D
D
D
D
D
D
D
D
D
D
"}
(37,1,1) = {"
D
D
D
D
g
g
v
v
b
b
b
l
F
b
F
O
Z
b
F
b
b
b
b
b
v
v
g
Q
D
D
D
D
D
D
D
D
D
D
D
D
"}
(38,1,1) = {"
D
D
D
D
g
g
v
v
b
b
O
b
F
F
b
b
b
F
F
Y
L
b
b
b
v
v
g
g
D
D
D
D
D
D
D
D
D
D
D
D
"}
(39,1,1) = {"
D
D
D
g
g
g
v
v
b
b
b
F
F
Y
F
b
b
b
z
F
F
b
b
b
v
v
v
g
D
D
D
D
D
D
D
D
D
D
D
D
"}
(40,1,1) = {"
D
D
D
g
g
v
v
v
b
b
b
A
b
F
b
F
b
F
F
F
F
b
b
b
b
v
v
g
D
D
D
D
D
D
D
D
D
D
D
D
"}
(41,1,1) = {"
D
D
D
g
g
v
v
v
b
b
b
F
F
l
F
F
F
Y
F
F
Y
b
b
b
b
v
v
g
D
D
D
D
D
D
D
D
D
D
D
D
"}
(42,1,1) = {"
D
D
D
g
g
v
v
v
v
b
b
F
F
O
b
F
b
M
F
b
b
b
b
b
b
v
v
g
D
D
D
D
D
D
D
D
D
D
D
D
"}
(43,1,1) = {"
D
D
D
g
g
v
v
v
v
b
e
F
F
F
F
F
F
F
l
b
F
b
b
b
b
v
v
g
g
D
D
D
D
D
D
D
D
D
D
D
"}
(44,1,1) = {"
D
D
D
g
g
v
v
v
v
b
b
F
F
F
L
Y
F
F
b
b
F
b
b
b
b
v
v
g
g
D
D
D
D
D
D
D
D
D
D
D
"}
(45,1,1) = {"
D
D
D
g
g
g
v
v
v
b
b
F
Y
F
b
F
y
F
b
b
F
b
b
b
b
v
v
g
g
D
D
D
D
D
D
D
D
D
D
D
"}
(46,1,1) = {"
D
D
D
g
g
g
v
v
v
b
b
F
F
F
b
b
b
r
b
F
A
b
b
b
v
v
v
g
g
D
D
D
D
D
D
D
D
D
D
D
"}
(47,1,1) = {"
D
D
D
g
g
g
G
v
v
b
b
b
F
L
F
b
b
F
F
b
F
b
b
b
v
v
v
g
g
D
D
D
D
D
D
D
D
D
D
D
"}
(48,1,1) = {"
D
D
D
D
g
g
g
v
v
v
O
F
b
b
F
R
b
F
F
b
F
O
b
b
v
v
v
g
Q
D
D
D
D
D
D
D
D
D
D
D
"}
(49,1,1) = {"
D
D
D
D
g
g
g
v
v
v
b
b
b
b
b
F
F
F
C
F
F
b
b
b
v
v
v
g
D
D
D
D
D
D
D
D
D
D
D
D
"}
(50,1,1) = {"
D
D
D
D
g
g
g
v
v
v
b
b
O
P
b
d
P
b
F
P
b
b
b
b
b
v
v
g
g
D
D
D
D
D
D
D
D
D
D
D
"}
(51,1,1) = {"
D
D
D
D
g
g
g
v
v
v
b
b
b
P
b
P
b
b
F
b
b
b
b
b
b
v
v
g
g
D
D
D
D
D
D
D
D
D
D
D
"}
(52,1,1) = {"
D
D
D
D
g
g
g
v
v
v
v
b
b
P
b
b
L
b
F
b
b
b
b
b
v
v
v
g
g
D
D
D
D
D
D
D
D
D
D
D
"}
(53,1,1) = {"
D
D
D
D
D
g
g
g
v
v
v
b
b
b
P
b
b
b
b
L
b
b
b
b
v
v
v
g
D
D
D
D
D
D
D
D
D
D
D
D
"}
(54,1,1) = {"
D
D
D
D
D
g
g
g
v
v
v
v
b
O
b
b
b
b
b
b
b
b
b
v
v
v
v
g
D
D
D
D
D
D
D
D
D
D
D
D
"}
(55,1,1) = {"
D
D
D
D
D
D
g
g
g
v
v
v
b
b
e
b
b
b
b
b
b
b
v
v
v
v
g
g
D
D
D
D
D
D
D
D
D
D
D
D
"}
(56,1,1) = {"
D
D
D
D
D
D
D
g
g
v
v
v
v
b
b
b
b
b
b
b
b
b
v
v
v
g
g
D
D
D
D
D
D
D
D
D
D
D
D
D
"}
(57,1,1) = {"
D
D
D
D
D
D
D
g
g
g
g
v
v
b
b
b
b
b
b
b
b
v
v
v
v
g
g
D
D
D
D
D
D
D
D
D
D
D
D
D
"}
(58,1,1) = {"
D
D
D
D
D
D
D
D
g
g
g
g
v
v
v
v
v
v
v
v
v
v
v
v
g
g
D
D
D
D
D
D
D
D
D
D
D
D
D
D
"}
(59,1,1) = {"
D
D
D
D
D
D
D
D
D
g
g
g
g
g
v
v
v
v
v
v
v
g
g
g
g
D
D
D
D
D
D
D
D
D
D
D
D
D
D
D
"}
(60,1,1) = {"
D
D
D
D
D
D
D
D
D
D
g
g
g
g
g
g
Q
g
g
g
g
g
g
D
D
D
D
D
D
D
D
D
D
D
D
D
D
D
D
D
"}
